1111111111111111111111111111111111111111111111111111111111111111111111111111111111111111111111111111
1111111111111111111111111111111111111111111111111111111111111111111111111111111111111111111111111111
1111111111111111111111111111111111111111111111111111111111111111111111111111111111111111111111111111
1111111111111111111111111111111111111111111111111111111111111111111111111111111111111111111111111111
1111111111111111111111111111111100000000000011111111111110000000000001111111111111111111111111111111
11111111abc11111111111111111111110000000000001111111111100000000000011111111111111111111111111111111
11111111def11111111111111111111111000000000000111111111000000000000111111111111111111111111111111111
11111111ghi11111111111111111111111100000000000011111110000000000001111111111111111111111111111111111
1111111111111111111111111111111111110000000000001111100000000000011111111111111111111111111111111111
1111111111111111111111111111111111111000000000000111000000000000111111111111111111111111111111111111
11111111111111111111111111111111111111000000000000100000000000011111111111111111abc11111111111111111
11111111111111111111111111111111111111100000000000000000000000011111111111111111def11111111111111111
11111111111111111111111111111111111111111111100000000000011111111111111111111111ghi11111111111111111
1111111111111111111111111111111111111111111111111111111111111111111111111111111111111111111111111111
1111111111111111111111111111111111111111111111111111111111111111111111111111111111111111111111111111
1111111abc111111111111111111111111111111111111111111111111111111111111111111111111111111111111111111
1111111def111111111111111111111111111111111111111111111111111111111111111111111111111111111111111111
1111111ghi111111111111111111111111111111111111111111111111111111111111111111111111111111111111111111
1111111111111111111111111111111111111111111111111111111111111111111111111111111111111111111111111111
1111111111111111111111111111111111111111111111111111111111111111111111111111111111111111111111111111
1111111111111111111110000000000011111111111111111111000000000000000000000000000000000111111111111111
1111111111111100000000000000111111111111111111111111111111111111111111111111111100000000000000000000
1111111111111111111100000000000000000000000000000000000000000000000000000000000000000000000000000000
1111111111111111111111111111111111111111111111111111111111111111111111111111111111111111111111111111
1111111111111111111111111111111111111111111111111111111111111111111111111111111111111111111111111111
0000000000000000000000000000000000000000000000000000000000000000000000000000000000000000000000000000
1111111111111111111111111111111111111111111111111111111111111111111111111111111111111111111111111111
0000000000000000000000000000000000000000000000000000000000000000000000000000000000000000000000000000
0000000000000000000000000000000000000000000000000000000000000000000000000000000000000000000000000000
0000000000000000000000000000000000000000000000000000000000000000000000000000000000000000000000000000
1111111111111111111111111111111111111111111111111111111111111111111111111111111111111111111111111111
1111111111111111111111111111111111111111111111111111111111111111111111111111111111111111111111111111
1111111111111111111111111111111111111111111111111111111111111111111111111111111111111111111111111111
1111111111111111111111111111111111111111111111111111111111111111111111111111111111111111111111111111
1111111111111111111111111111111100000000000011111111111110000000000001111111111111111111111111111111
11111111abc11111111111111111111110000000000001111111111100000000000011111111111111111111111111111111
11111111def11111111111111111111111000000000000111111111000000000000111111111111111111111111111111111
11111111ghi11111111111111111111111100000000000011111110000000000001111111111111111111111111111111111
1111111111111111111111111111111111110000000000001111100000000000011111111111111111111111111111111111
1111111111111111111111111111111111111000000000000111000000000000111111111111111111111111111111111111
11111111111111111111111111111111111111000000000000100000000000011111111111111111abc11111111111111111
11111111111111111111111111111111111111100000000000000000000000011111111111111111def11111111111111111
11111111111111111111111111111111111111111111100000000000011111111111111111111111ghi11111111111111111
1111111111111111111111111111111111111111111111111111111111111111111111111111111111111111111111111111
1111111111111111111111111111111111111111111111111111111111111111111111111111111111111111111111111111
1111111abc111111111111111111111111111111111111111111111111111111111111111111111111111111111111111111
1111111def111111111111111111111111111111111111111111111111111111111111111111111111111111111111111111
1111111ghi111111111111111111111111111111111111111111111111111111111111111111111111111111111111111111
1111111111111111111111111111111111111111111111111111111111111111111111111111111111111111111111111111
1111111111111111111111111111111111111111111111111111111111111111111111111111111111111111111111111111
1111111111111111111110000000000011111111111111111111000000000000000000000000000000000111111111111111
1111111111111100000000000000111111111111111111111111111111111111111111111111111100000000000000000000
1111111111111111111100000000000000000000000000000000000000000000000000000000000000000000000000000000
1111111111111111111111111111111111111111111111111111111111111111111111111111111111111111111111111111
1111111111111111111111111111111111111111111111111111111111111111111111111111111111111111111111111111
0000000000000000000000000000000000000000000000000000000000000000000000000000000000000000000000000000
1111111111111111111111111111111111111111111111111111111111111111111111111111111111111111111111111111
0000000000000000000000000000000000000000000000000000000000000000000000000000000000000000000000000000
0000000000000000000000000000000000000000000000000000000000000000000000000000000000000000000000000000
0000000000000000000000000000000000000000000000000000000000000000000000000000000000000000000000000000
1111111111111111111111111111111111111111111111111111111111111111111111111111111111111111111111111111
1111111111111111111111111111111111111111111111111111111111111111111111111111111111111111111111111111
1111111111111111111111111111111111111111111111111111111111111111111111111111111111111111111111111111
1111111111111111111111111111111111111111111111111111111111111111111111111111111111111111111111111111
1111111111111111111111111111111100000000000011111111111110000000000001111111111111111111111111111111
11111111abc11111111111111111111110000000000001111111111100000000000011111111111111111111111111111111
11111111def11111111111111111111111000000000000111111111000000000000111111111111111111111111111111111
11111111ghi11111111111111111111111100000000000011111110000000000001111111111111111111111111111111111
1111111111111111111111111111111111110000000000001111100000000000011111111111111111111111111111111111
1111111111111111111111111111111111111000000000000111000000000000111111111111111111111111111111111111
11111111111111111111111111111111111111000000000000100000000000011111111111111111abc11111111111111111
11111111111111111111111111111111111111100000000000000000000000011111111111111111def11111111111111111
11111111111111111111111111111111111111111111100000000000011111111111111111111111ghi11111111111111111
1111111111111111111111111111111111111111111111111111111111111111111111111111111111111111111111111111
1111111111111111111111111111111111111111111111111111111111111111111111111111111111111111111111111111
1111111abc111111111111111111111111111111111111111111111111111111111111111111111111111111111111111111
1111111def111111111111111111111111111111111111111111111111111111111111111111111111111111111111111111
1111111ghi111111111111111111111111111111111111111111111111111111111111111111111111111111111111111111
1111111111111111111111111111111111111111111111111111111111111111111111111111111111111111111111111111
1111111111111111111111111111111111111111111111111111111111111111111111111111111111111111111111111111
1111111111111111111110000000000011111111111111111111000000000000000000000000000000000111111111111111
1111111111111100000000000000111111111111111111111111111111111111111111111111111100000000000000000000
1111111111111111111100000000000000000000000000000000000000000000000000000000000000000000000000000000
1111111111111111111111111111111111111111111111111111111111111111111111111111111111111111111111111111
1111111111111111111111111111111111111111111111111111111111111111111111111111111111111111111111111111
0000000000000000000000000000000000000000000000000000000000000000000000000000000000000000000000000000
1111111111111111111111111111111111111111111111111111111111111111111111111111111111111111111111111111
0000000000000000000000000000000000000000000000000000000000000000000000000000000000000000000000000000
0000000000000000000000000000000000000000000000000000000000000000000000000000000000000000000000000000
0000000000000000000000000000000000000000000000000000000000000000000000000000000000000000000000000000